xxxxxxxxxxxxxxxxxxxx
x******************x
x***x**x**x**x**x**x
x******************x
x******************x
x**x**x**x**x**x***x
x******************x
x***x**x**x**x**x**x
x******************x
x******************x
x**x**x**x**x**x***x
x******************x
x***x**x**x**x**x**x
x******************x
xxxxxxxxxxxxxxxxxxxx
